1,10,10,10,10,10,10,10,10,10,10,10,10,10,10,5,9,9,9,9,9,9,9,9,9,9,9,9,9,2,
13,17,17,17,17,17,17,17,17,17,17,17,17,17,17,17,17,17,17,17,17,17,17,17,17,17,17,17,17,15
13,17,17,17,17,17,17,17,17,17,17,17,17,17,17,17,17,17,17,17,17,17,17,17,17,17,17,17,17,15
13,17,17,17,17,17,17,17,17,17,17,17,17,17,17,17,17,17,17,1,2,17,17,17,17,17,17,17,17,15
13,17,17,17,17,17,17,17,17,17,17,17,17,17,17,17,17,17,17,13,15,17,17,17,17,17,17,17,17,15
13,17,17,17,17,17,17,17,17,17,17,17,17,17,17,17,17,17,17,13,15,17,17,17,17,17,17,17,17,15
13,17,17,17,17,17,17,17,17,17,17,17,17,17,17,17,17,17,17,7,8,17,17,17,17,17,17,17,17,15
13,17,17,17,17,17,17,17,17,17,17,17,17,17,17,17,17,17,17,13,15,17,17,17,17,17,17,17,17,15
7,17,17,17,17,17,17,17,17,17,17,17,17,17,17,17,17,17,17,13,15,17,17,17,17,17,17,17,17,8
14,17,17,17,17,17,17,17,17,17,17,17,17,17,17,17,17,17,17,3,4,17,17,17,17,17,17,17,17,16
14,17,17,17,17,17,17,17,17,17,17,17,17,17,17,17,17,17,17,17,17,17,17,17,17,17,17,17,17,16
14,17,17,17,17,17,17,17,17,17,17,17,17,17,17,17,17,17,17,17,17,17,17,17,17,17,17,17,17,16
14,17,17,17,17,17,17,17,17,17,17,17,17,17,17,17,17,17,17,17,17,17,17,17,17,17,17,17,17,16
14,17,17,17,17,17,17,17,17,17,17,17,17,17,17,17,17,17,17,17,17,17,17,17,17,17,17,17,17,16
14,17,17,17,17,17,17,17,17,17,17,17,17,17,17,17,17,17,17,17,17,17,17,17,17,17,17,17,17,16
14,17,17,17,17,17,17,17,17,17,17,17,17,17,17,17,17,17,17,17,17,17,17,17,17,17,17,17,17,16
3,11,11,11,11,11,11,11,11,11,11,11,11,11,11,6,12,12,12,12,12,12,12,12,12,12,12,12,12,4